NO ./Textures/xpm/egypt/egypt_wall_north.xpm
WE ./Textures/xpm/egypt/egypt_wall_east.xpm
SO ./Textures/xpm/egypt/egypt_wall_north.xpm
EA ./Textures/xpm/egypt/egypt_wall_east.xpm

F 179,144,96
C 159,228,245

        1111111111111111111111111111111
        100D000000110000000000000000001
        1001000000100000000000000000001
        1001000000D00000000000000000001
        1001000000100000000000000000001
111111111011000000110000000000000000001
100000000011000001111D1111111D111111111
11100011111111D11100000010000000001
1111D111111110001101010010000000001
11000000110100000100000010000000001
10000000000000000D00000010000000001
10000000000000000101010010000000001
11000001110101011111011110000N0000111
11110111 1110101 101111010000000001
11111111 1111111 111111111111111111

